##########
#   ff   #
# ### ##f#
#fffff  f#
##fff#  ##
# ##f#f###
####  f  #
# # #ff# #
### #f####
# ff#ffff#
# #  ff# #
##########
